R   1920    1080

NO  ./textures/xpm/wall.xpm
SO  1,2,3
WE  1,2,3
EA  ./textures/xpm/wall.xpm

S   ./textures/xpm/wall.xpm
F   4,5,6
C   skybox ./textures/xpm/wall.xpm
11111
10001
10N01
10001
11101
111011111111111111111111
100000000000000000000001
100000000000000000000001
100000000000000000000001
100000111110000101110001
100000100010000100000001
100000100010000101010001
100000100010000000010001
100000110110000111010001
100000000000000000000001
100000000000000000000001
100000000000000000000001
100000000000000000000001
100000000000000000000001
100000000000000000000001
100000000000000000000001
111111111000000000000001
110100001000000000000001
110000101000000000000001
110100001000000000000001
110111111000000000000001
110000000000000000000001
111111111000000000000001
111111111111111111111111