               R 960 540
  NO                  ./textures/wall.xpm
       SO                  1,2,3



WE                  1,2,3







        EA                 ./textures/wall.xpm







  S      ./textures/wall.xpm
      F       4,5,6
             C      skybox                  ./textures/wall.xpm
C       8,9,18
11111
10001
10S01
10001
10101
11111