               R 192 -1
  NO                  ./textures/wall.xpm
       SO                  1,2,3



WE                  1,2,3







        EA                 ./textures/wall.xpm







  S      ./textures/wall.xpm
      F       4,5,6
             C      skybox                  ./textures/wall.xpm
C       8,9,18
                                         1111111111111111111111111
                                         1000000000110000000000001
                                         1011000001110000002000001                                                   1
                                         1001000000000000000000001
                                 111111111011000001110000000000001
111111111111111111111111111111111100000000011000001110111111111111
10000000000000000000000000000000011110111111111011100000010001
10111111111111111111111111111111111110111111111011101010010001                                   
101                              11000000110101011100000010001
101111111111111111111111111111111100020000N0000001100000010000
10000000000000000000000000000000000000000000000001101010010001
1111111111111111111111111111111111100000111010101111101111000111
                                 11110111 1110101 101111010001
                                 11111111 1111111 111111111111