R   1920    1080

NO  ./textures/minecraft/oak_planks.xpm
SO  ./textures/minecraft/oak_planks.xpm
WE  ./textures/minecraft/oak_planks.xpm
EA  ./textures/minecraft/oak_planks.xpm

S   ./textures/minecraft/torch.xpm
F   ./textures/minecraft/stone_bricks.xpm
C   ./textures/minecraft/purpur_block.xpm
              1111111111
              1000000001
              1001111011
              1000001001
              1000001101
              1000001001
              1000111011
              1000100001
        1111111111101111111111111
        1000000000001200000000001
        1011000001111001000000001
        1001000000000000000212001
111111111011000001110000000000001
100000000011000001110111111111111
11110111111111011100000010001
11110111111111011101010010001
11000000110101011100000010001
10002000000000001100000010001
10000000000000001101010010001
1100000111010101111101111000111
10100111 1110101 101111010001
10001111 1111111 111111111111
11011
10001
10001
10001
11011
112111111111111111111111111111111111111111111111111111111111
100000000000000000000000000000000000000000000000000000000001
10N000000000000000000000000000000000000000000000000000000001
100000000000000000000000000000000000000000000000000000000001
100000000000000000000000000000000000000000000000000000000001
100000000000000000000000000000000000000000000000000000000001
100000000000000000000000000000000000000000000000000000000001
100000000000000000000000000000000000000000000000000000000001
100000000000000000000000000000000000000000000000000000000001
100000000000000000000000000000000000000000000000000000000001
100000000000000000000000000000000000000000000000000000000001
100000000000000000000000000000000000000000000000000000000001
111111111111111111111111111111111111111111111111111111111111